Primary Succession	First ecology
primary structure	First protein
Secondary Succession	Second ecology
Tertiary Structure	Third protein
Insect	Six legs
Condense	Abbreviate
Condensation polymerization	Abbreviate Monomers
condensation reaction	Abbreviation comeback
Topsoil	Above humus
precision	Accuracy
base	Acid
Amphoteric	Acid base
Neutralization reaction	Acid base
hydronium ion	acid drake
Corrosion	Acidic destruction
Buffering capacity	Acidity limit
buffered solution	Acidity solvent
lanthanide contraction	actinide pregnancy
lanthanide series	actinide row
Hydration	Adding water
Acclimatization	Adjust change
Recombination	Again permutation
atmosphere	Air general
Smog	Air pollution
Stress	Albert's chair
Benzyl	Alcock Ring
Eutrophic	Algal bloom
Corolla	All petals
Calyx	All sepals
Delta	Alluvial Fan
Beta particle	Alpha
Bauxite	Aluminum ore 
Adiabatic	Always appears
angstrom	Amino distance
side chain	Amino group
current	Amperes measure
Catabolic pathway	Anabolic route
metabolism	Anabolism catabolism
Metaphase	Anaphase
wheel	And axle
anatomy	And physiology
halocline	angel calvin
gymnosperm	Angiosperm
Azimuth	Angle horizon
Habitat	Animal home
Niche	Animal role
Amine	Anime
amino acid	Anime base
cation	Anion
cathode	Anode
Cathode ray	Anode beam
Ice cap	Antarctica biome
Stamen	Anther Filament
antigen	Antibody
antibody	Antigen
Chief cell	Apache Jail
chemistry	Aparicio
chemical equilibrium	Aparicio balance
chemical formula	Aparicio Equation
chemical equation	Aparicio formula
chemical bond	Aparicio james
chemical change	Aparicio modification
chemical kinetics	aparicio movement
Chemotroph	Aparicio producer
perihelion	Aphelion
Water	Aqua
Water cycle	Aqua bike
parabolic motion	Arc Movement
volume	Area
vein	Artery
Cholesterol	Artery fat
Atherosclerosis	Artery Plaque
Bitumen	Asphalt
crater	Asteroid impact
steroid	Athlete Drug
Greenhouse effect	Atmosphere warming
Sinoatrial node	Atrioventricular node
concentration cell	Auschwitz Jail
Barrier Reef	Australia coral
mole	Avogadro
Molar volume	Avogadro area
mole ratio	Avogadro Fraction
mole fraction	Avogadro Ratio
molar mass	Avogadro Weight
Distal	Away center 
dendrite	Axon
abortion	Baby killing
pharynx	back throat
spinal cord	Backbone
vertebrate	Backbone haver
Retrovirus	Backwards bacteria
reversible process	Backwards Method
reverse osmosis	Backwards Osmond
Virus	Bacteria
Viroid	Bacteria asteroid
sex pili	Bacteria Penis
binary fission	Bacteria Reproduction 
Equilibrium	Balance
medulla oblongata	Balance Brain
equilibrium constant	Balance kaylene
Pressure	Barometer measures
torr	Pressure unit
acid	Base
acid rain	Basic precipitation
Acidic oxide	Basic Reduce
echolocation	Bat vision
Voltage	Battery power
volt	Battery unit
Legume	Bean general
synnecrosis	Bee sting
Zygote	Before Embryo
prefrontal cortex	Before Forward
larva	before pupa
Bedrock	Below humus
Alkene	Benzene
alpha particle	Beta
antiparallel	Beta direction
Macrophage	Big bacteria
hurricane	Big tornado
Bacteriophage	Big virus
tsunami	Big wave
Arteriole	Bigger Capillary
ribulosebiphosphatecarboxlyaseoxygenase	Biggest Enzyme
Allosteric Enzyme	Binding changer
Meson	Binks particle
Enzyme	Biological catalyst
Fluorescence	Bioluminescence
Luciferin	Bioluminescence chemical
Torpor	Bird Hibernation
quasar	Black Hole
phospholipid	Blank Bilayer
Algae	Blank bloom
Lactose	Blank intolerant
Protein	Blank modeling
binomial	Blank nomenclature
compound	Block
coagulation	Blood clotting
hemoglobin	Blood protein
Wind	Blow
Cyanobacteria	Blue plankton
Homeostasis	Body Equilibrium
somatic damage	Body Harming
Binding energy	Bond joules
Troposphere	Bottom atmosphere
Benthic Zone	Bottom ocean
Estuary	Brackish water
Action Potential	Brain impulse
lung	breathing organ
Cell Wall	Brick organelle
Scintillation	Brilliantly Exciting 
muscle	Buff tissue
titration	Buret process
combustion	Burning oxygen
Biofuel	Burning wood
Competition	Businesses need
gluteus maximus	Butt muscle
abyssal zone	Buttcrack area
metamorphosis	Butterfly changing
Tundra	Canada biome
carcinogen	Cancer particle
Manometer	Cancerous U
resistance	Capacitance
radioactive decay	Carbon Dating
Functional Group	Carboxyl general 
Anabolic pathway	Catabolic route
anode	Cathode
anion	Cation
Cytoskeleton	Cell Bones
pinocytosis	Cell drinking
phagocytosis	cell eating 
Adenosine Triphosphate	Cell fuel
Cytoplasm	Cell gel
Cilia	Cell hair
Organelle	Cell part
Mitochondria	Cell power
Vesicle	Cell Sac
Plastid	Cell Storage
Vacuole	Cell Storage
Flagellum	Cell Tail 
Lysosome	Cell Trash
Nucleolus	Cell yolk
Nucleus	Center Atom
Basal Body	Centriole organelle
Cerebrum	Cerebellum
Cerebellum	Cerebrum
jerk	Changing Acceleration
Adaptive Immunity	Changing Vaccine
acceleration	Changing velocity
coulomb	Charge unit
physical change	Chemical Modification
Radiation	Chernobyl
Deciduous Forest	Chest hairs
Enantiomers	Chiral Molecules 
Notochord	Chordata
Kinetochore	Chromatid attach
cocoon	Chrysalis
pupa	Chrysalis
Mollusk	Clams general
global warming	Climate change
Time dilation	Clock eyedrop
Quartz	Mohs 7
parenchyma	Collenchyma
suspension	Colloid
colligative properties	Colloid attributes
Large Intestine	Colon
Chromatography	Color analysis
Reaction coordinate	Comeback Descartes
reaction quotient	Comeback Division
Reaction mechanism	Comeback gear
reaction rate	Comeback Speed
Mutualism	Commensalism
Binary	Computer
binary compound	Computer block
convex	Concave
Habituation	Conditioning
Learned Behavior	Conditioning Habituation
codon	Condom
Tropical Rainforest	Congo biome
pollution	Contamination
divergent boundary	Convergent border
divergent evolution	Convergent creationism
concave	Convex
sex	Copulation!!!
Lagoon	Coral lake
valence electron	core positron
Saprophyte	Corpse grower 
Ionic Solid	Covalent Liquid 
skin	Covering Organ
Muon	Cow particle
Crustacean	Crab general
collision model	Crashing upton
evolution	Creationism
feedback inhibition	Criticism prevention
Independent assortment	Crossover
lattice	crystal structure
Centriole	Cylinder organelle
disulfide bond	Cysteine link
Molecule	Dalton
molecular substructure	Dalton Edifice 
molecular formula	Dalton equation
intermolecular forces	Dalton Newton
auxin	Dark hormone
Aphotic Zone	Dark ocean
natural selection	Darwin
fossil	Dead dinosaur
white dwarf	Dead star
coordination compound	Descartes block
significant figures	Decimal Numbers
Synthesis	Decomposition
Melt	Defrost
melting point	Defrost decimal
Alluvial Fan	Delta
atom	Democritus
atomic nucleus	Democritus Center
atomic weight	Democritus Mass
atomic number	Democritus numeral
atomic solid	Democritus Potty
atomic mass	Democritus weight
axon	Dendrite
tooth	Dental piece
Gene expression	helix facial
gel electrophoresis	helix lab
nucleic acid	helix Ribo
genetics	helix study
helicase	helix unwinder
Ribonucleic acid	helix other
Phosphodiester	helix bond
rain shadow	Desert Mountain
autosome	Deuterosome
probability	Dice Rolling
effusion	Diffusion
peristalsis	Digestive motion
Stoichiometry	Dimensional analysis
Fossil fuels	dinosaur energy
Aneuploidy	Diploid haploid
stomach	Digestive Organ
solubility	Dissolving Property
meter	Distance Unit
filtration	distillation
convergent boundary	Divergent border
convergent evolution	Divergent creationism
operator	Division sign
Parasitism	Dog fleas
bark	Dog Says
Ion	Drake
Ion Pairing	Drake apple
Ionic bond	Covalent james
ion exchange	drake trade
deposition	Dropping silt
mushroom	Drug fungi
Ground water	Earth aqua
groundwater	Earth aqua
Soil acidification	Earth basic
Core	Earth center
orbit	Earth ellipse
Albedo	Earth reflection
Geology	Earth study
Ground state	Earth nation
fault	Earthquake line
amoeba	Easy drawing
Food web	Eating chain
Food pyramid	Eating egyptian
Food chain	Eating web
Structural Formula	Edificial equation
hypothesis	educated guess
Algorithm	Efficient code
diffusion	Effusion
octet rule	Eight Electrons
sunlight	Eight Minutes
oxygen	Eighth element
relativity	Einstein Special
photoelectric effect	Einstein Theory
Circuit	Electrical integrated
hydrolysis	electrolysis method
Positron Production	Electron Creation
orbital	Electron ellipse
Lepton	Electron general
Focus	Ellipse point
Eccentricity	Ellipse roundness
Freeze	Elsa
Freezing point	Elsa decimal
Unsaturated fat	Empty oil
restriction enzymes	Endonuclease
entropy	Enthalpy
enthalpy	Entropy
Activation Energy	Enzyme joule
Active site	Enzyme location
Substrate	Enzyme partner
Imprinting	Epson behavior
Isotonic	Equally filled
equivalence point	Equilibrium decimal
equilibrium point	Equivalence decimal
weathering	Erosion
Hibernation	Estivation
Brackish water	Estuary aqua
Continental shelf	Eurasian book
Continental divide	Eurasian Quotient 
Continental Rise	Eurasian growth
vaporization	evaporation
Adaptation	Evolutionary modification
Chitin	Exoskeleton protein 
free radical	Expensive Conservative
Carbon cycle	Factory bike
placebo	Fake medicine
Natural law	Fake Theory 
gravity	Falling
meteor	Falling Rock
meteorite	Falling Rock
meteoroid	Falling Rock
network solid	System liquid
System	Network
magnetic	faraday
Horizon	Farthest vision
tachyon	Faster Light
lipid	fat molecule
Sporophyte	Fern general
optics	Fiber blank
end point	Final decimal
pyrometallurgy	Fire Steel
Foundation species	First organisms
mercury	First planet
fin	Fish arm
fusion	Fission
Reactor core	Fission Center
Nitrogen cycle	Fixation bike
Acoelomate	Flatworm general
pollen	Flower Allergen
Pistil	Flower gun
Sepal	Flower holder
petal	Flower leaf
Peduncle	Flower supporter
Bioluminescence	Fluorescence
paramagnetism	For Faraday
work	Force distance
luminosity	formal brightness
Gene	Former president
Frontal Lobe	Forward brain
keystone species	foundation organism
plasma	Fourth State
scientific method	Francis Bacon
period	Frequency inverse
Amphibian	Frog general
saturated	Full Fat
Saturated fat	Full oil
carboxylic acid	functional base
Carbonyl	Functional Carbon
Carboxyl	Functional cow
Aldehyde	Functional Fragrance
Hydroxyl	Functional Hydrogen
Phenyl	Functional Indicator
Phophate	Functional Phosphorus
Sulfide	Functional Sulfur
Hyphae	Fungi roots
fission	Fusion
Gastrula	Galena
Barrier Island	Galveston general
Galena	Gastrula
electrolyte	Gatorade
electrolytic cell	Gatorade jail
Trans fat	Gay oil
Dichotomous key	Gay test
Deoxyribonucleic acid	Genetic Code
Mutation	Genetic modification
Polarization	Genocide Step 
phenotype	Genotype
Heart attack	Geoffrey palpitations
heart	Geoffrey
free energy	Gibbs blank
moraine	Glacier bottom
resonance	Glass Shattering
Sugar	Glucose general
Carbon Steel	Graphite iron
aster	Greek Star
plant	Green Organism
chlorophyll	Green stuff
earthquake	Ground shaking
Angiosperm	Gymnosperm
Conditioning	Habituation
particle accelerator	Hadron Collider
Semipermeable membrane	Half passing
Metalloid	Half steel 
semiconductor	Half Train
subshell	Half Turtle
inclined plane	half wedge
comet	Halley's blank
diploid	Haploid
physics	Hart
Absorption	Hart hates
Adsorption	Hart hates
Vascular plants	Have xylems
thermocline	Heat calvin
thermal pollution	Heat Contamination
Calorimetry	Heat Study
uncertainty	Heisenberg principle
Partial Pressure	Half barometer
Cytochrome	Hemeprotein 
carnivore	Herbivore
omnivore	Herbivore carnivore
Cortex	Hernan
Estivation	Hibernation
boson	Higgs
Bronchiole	Holds alveoli
battery	Volt holder
porous	Holey
porous disk	Holey Circle
nebula	Horsehead blank
Thermosphere	Hot atmosphere
color	Hue
Mammal	Human general
genome	Human project
Soil	Humus general
organic chemistry	Hydrocarbon aparicio
organic acid	Hydrocarbon base
Electrolysis	Hydrolysis method
Adrenal gland	Hype Producer
Supercooling	Hyper Heating 
superposition	Hyper Location
supernova	Hyper Man
sedimentary rock	Igneous Metamorphic
inertia	impedus
critical pressure	Important barometer
Critical reaction	Important comeback
Critical point	Important decimal
critical temperature	Important thermometer
Critical mass	Important weight
Crossover	Independent Assortment
cyclone	Indian hurricane
typhoon	Indian hurricane
monsoon	Indian rain
Fiber optics	Indigestible lights
Impetus	Inertia
Endoderm	Inner skin
Arthropod	Insect general
endothermic	Inside heat
internal energy	inside joule
pancreas	Insulin Producer
Tardigrade	Invinvible microorganism
halogen	Iodine general
Covalent bond	Ionic james
lattice energy	ionic joule
electron affinity	ionization energy
aqueous solution	Ions Water
Steel	Iron Alloy
myoglobin	Iron Binding
newton	Issac
Cell	Jail 
Cellular Respiration	Jail breathing
cell potential	Jail kinetic
bond	James
bonding pair	James apple
bond energy	James joule
bond length	James meter
Bond order	James phylum
Mesentery	Jar Tissue
Cnidarian	Starfish General 
cross linking	Jesus Attaching
Amensalism	Jesus mutualism
energy	Joule
Energy pyramid	Joule egyptian
model	Kate Upton
silicates	Keeps Dry
dialysis	Kidney supporting
Collecting Duct	Kidney tubes
altruism	kindness
potential energy	Kinetic Joule
Centromere	Kinetochore location
spindle fibers	Kinetochore Releases
Leading strand	Lagging deoxy
actinide series	Lanthanide row
small intestine	Large Colon
glacier	large ice
colon	Large Intestine
magma	lava
theory	Law
screw	Lead Pitch
lagging strand	Leading helix
Stomata	Leaf holes
Axillary bud	Leaf origin 
Behavior	Learned blank
simple machine	Lever general
Moss	Lichen
Biodiversity	Life variety 
Photo	Light
Photochemical smog	Light Aparicio
refraction	Light Bending
Photosynthesis	Light decomposition
Photic Zone	Light ocean
photon	Light particle
Diffraction	Light slit
black hole	Quasar
Advection	Liquid heat
viscosity	Liquid thickness
alkali metal	Lithium general
bile	Liver liquid
Lake	Livingston
Reptile	Lizard general
Ketone	Lock Note
Transverse Wave	Longitudinal tsunami
Pasteurization	Louis milk
dilution	Lowering acidity
absolute zero	Lowest temperature
alveoli	Lung grapes
lava	magma
Buffer	Maintains acidity
Acidification	Making base
Amplification	Making Bigger
Halogenation	Making Iodine
Polymerization	Making monomer
ammonification	Making nitrogen 
double fertilization	Making twins
hermaphrodite	Male female
polypeptide	Many Aminos
Biosphere	Many biomes
Polyatomic ion	Many Democritus
Biome	Many ecosystems
Ecosystem	Many habitats
polyprotic acid	Many Hydrogens
Population	Many individuals
ovule	Many ovaries
group	Functional blank
Community	Many populations
asteroid belt	Mars Jupiter
Swamp	Marsh
weight	Mass
Higgs Boson	Mass particle
momentum	Mass velocity
density	Mass Volume
annihilation	Matter antimatter
Activated Complex	Maximum Energy
ampere	Current unit
Environment	Medium ambient
mitosis	Meiosis
Active Transport	Membrane crossing
Passive transport	Membrane crossing
Periodic Table	Mendeleev
transition metal	Mendeleev middle
element	Mendeleev substance
smelting	Metal Defrost
alloy	Metal mixing
Blast Furnace	Metallurgy heater
anaphase	Metaphase
Alkane	Methane
Alcohol	Methanol
Alkyne	Methyne 
Mesosphere	Middle atmosphere
Mantle	Middle earth
mesoderm	Middle skin
intermediate	middle step
Brain stem	Mind plant
endocytosis	Mineral eating
Exocytosis	Mineral pooping
Chromatid	Mini chromosome
Radial symmetry	Mirror circle
bilateral symmetry	Mirror two
meiosis	mitosis
rhizome	Modified Root
Talc	Mohs 1
Diamond	Mohs 10
Gypsum	Mohs 2
Calcite	Mohs 3
Fluorite	Mohs 4
Apatite	Mohs 5
Orthoclase/Feldspar	Mohs 6
Topaz	Mohs 8
Corundum	Mohs 9
empirical formula	Molecular Equation
molality	Avogadro kilogram
molarity	Avogadro liters
Polymer	Monomer
Lunar Eclipse	Moon covering
Lichen	Moss
Landform	Mountain general 
oral cavity	Mouth hole
Active Immunity	Moving Vaccine
Oligotroph	Multi producer
Actin	Multi Protein 
biology	Murchison
biomolecule	Murchison dalton
fungus	Mushroom general
spore	Mushroom Seed
hybrid orbitals	Musk circles
hybridization	Musk making
symbiosis	Mutual blank
Commensalism	Mutualism
Reflection	Narcissus pond
State function	Nation Purpose
Positive feedback	Negative criticism
Electron	Negative particle
kidney	nephrons in
Acetylcholine	Neurotransmitter 
Neutron	Neutral particle
pulsar	Neutron Star
force	Newton
River	Nile
nucleotide	Nitrogenous Base
invertebrate	no backbone
abiotic	Nonliving
cartilage	Nose bone
Crystal	Amorphous Solid
Ventricle	Atrium
Irreversible Process	Not Backwards
herbivore	Carnivore
plasmid	Chromosomal
Weather	Climate
anticodon	Condom
insulator	Conductor
amorphous solid	Crystal
Coniferous forest	Deciduous
Positron	Electron
matter	Energy
limiting reactant	Not excess
wavelength	Frequency
nonelectrolyte	Not gatorade
Latitude	Longitude
Longitude	Latitude
immiscible	not mixable
Invasive species	Not Native
Tau	Neutrino
Vitamin	Nutrient
Steppe	Savannah
vector	Scalar
nonmetal	Not steel
Tropical Savannah	Steppe
heat	Temperature
Antibiotic	Vaccine
atrium	Ventricle
Nutrient	Vitamin
frequency	Wavelength
Climate	Weather
Chordata	Notochord
nitrogenous base	Nucleotide
Carbohydrate	Nutrition bread
Fiber	Nutrition Indigestible
Fat	Nutrition oil
Ester	Nylon poly
fatty acid	obese base
Plankton	Ocean bacteria
Coral reef	Ocean rainforest
Basalt	Ocean rock
Cephalopod	Octopus general
Archaea	Oldest bacteria
single bond	One James
Monomer	Polymer
monosaccharide	One sugar
Chirality	Opposite mirror
Hydrocarbon	Organic molecules
Carboxylate	Original ester
osmosis	Osmond
osmotic pressure	Osmond barometer
Heterotroph	Other producer
Exosphere	Outer atmosphere
Crust	Outer earth
exothermic	Outside heat
ectoderm	Outside skin
Hypertonic	Overfilled
Pons	Owned brain
reduction	Oxidation
reducing agent	Oxidizing Spy
electronegativity	oxygen property
Ocean	Pacific blank
Golgi Body	Packaging organelle
amygdala	Padme
alimentary canal	Palmer Venice
insulin	pancreas produces
autoimmune disease	Papillona virus
aphelion	Perihelion
collenchyma	Parenchyma
sclerenchyma	Parenchyma
Parietal Lobe	Parent brain
permeation	Seeping water
bladder	Pee holder
Dimer	Penny
Salt bridge	Pepper protein
Residue	Peptide unit
ideal gas	Perfect fart
Apogee	Perigee
normal force	Perpendicular newton
normality	Perpendicularity
fuel cell	petroleum jail
genotype	Phenotype
xylem	Phloem
sigma bond	Pi James
Bird	Pigeon general
lead	Pipe element
harmonic	Pipe sound
Ovary	Pistil bottom
Style	Pistil stem
Stigma	Pistil top
Humus	Pita bread
Fundamental Frequency	Pitch Giver
seed	Plant Baby
root	Plant bottom
Abscisic Acid	Plant hormone 
Chloroplast	Plant organelle
stem	Plant stick
Transpiration	Plant sweating
leaf	plant wings
Doppler effect	Police siren
allergen	Pollen general
volcano	Pompeii
appendix	Pooja Lacks
feces	Poop
excretory system	Pooping network
Carrying capacity	Population limit
Negative feedback	Positive criticism
Proton	Positive particle
electron capture	positron kidnapping
anterior pituitary	Posterior Gland
kinetic energy	potential joule
ceramic	Pottery other
watt	Power unit
accuracy	Precision
Autoclave	Pressure chamber
barometer	Pressure Measurer
Predator	Prey
reactant	Product
solar flare	Prominence
Telophase	Prophase
immune system	Protection network
Denature	Protein breaking 
Ribosomes	Protein factory
Hydrogen Bonding	Protein folding
Ligand	Protein magnesium
Baryon	Proton general
dinosaur	Pterodactyl general
neutron star	Pulsar
allele	Punnett square
Glycolysis	pyruvate maker
quantization	Qualification
mechanics	quantum blank
Quark	Quantum particle
Fermion	Quantum questions
Piezoelectric	Quartz Property
gamma ray	Quasars emit
uranium	Radioactive element
precipitation reaction	Rainfall Comeback
specific heat	Raise Degree
Adaptive Radiation	Rapid Diversification 
rodent	Rat general 
product	Reactant
Percent Yield	Reaction amount
Inhibitor	Reaction slower
Catalyst	Reaction speeder
control rods	Reactor Poles
moderator	Reddit Controller
oxidation-reduction reaction	Redox
Oxidizing agent	Reducing spy
oxidation	Reduction 
Atoll	Reef ring
oxidation states	Refuction Texas
denitrification	Removing nitrogen
Amniotic egg	Reptile baby
Conservation	Republican
capacitor	Resistor
rotation	Revolution
hippocampus	Rhinoceros brain
hypothalamus	Rhinoceros gland
Endoplasmic Reticulum	Ribosomes on
Flood plain	River range
Silt	River soil
Levee	Riverbank wall
Lithosphere	Rock earth
mineral	Rocks and
node	Root fixator
Nitrogen Fixation	Root nodes
pulley	Rope machine
revolution	Rotation
torque	Rotational force
Nematode	Roundworms
noble gas	Royal fart
friction	Rubbing Surfaces
Taiga	Russia biome
Desert	Sahara biome
Saltwater Intrusion	Saline Trespassing
Desalination	Salt Removal 
solution	Salt Water
isobaric	Same barbarian
Isochloric	Same Chlorine
Formula Equation	Same Clue
isoelectronic ions	same drake
isothermic	same heat
Symmetry	Same Mirror
isomer	same monomer
isotopes	same neutron
polar molecule	Santa dalton
Dipole moment	Santa Second
metamorphic rock	Sedimentary Igneous
lever	see saw
Autoionization	Self charging
asexual reproduction	Self Copulation
Autotroph	Self producer
Half reaction	Semi comeback
Vascular cambium	Separates xylem
gamete	sex cell
brown dwarf	Short indian
r-strategists	Short Life
indicator	Shows acidity
pi bond	Sigma James
Ecology	Silent Spring
Nature	Silent spring
Boil	Simmer
boiling point	Simmering decimal
Complex	Simple
complex ion	Simple drake
Oscillation	Sine Wave
lone pair	single apple
monoprotic acid	Single hydrogen
Unit Cell	Single Jail 
Individual	Single organism
atrioventricular node	Sinoatrial node
standing wave	Sitting Tsunami
bone	Skeleton material
Cell membrane	Skin organelle
membrane	skin organelle
chain reaction	Slave comeback
spring constant	Slinky Kaylene
nanotube	Small carbon
granule	small grain
tornado	Small hurricane
venule	Small Vein
Capillary	Smallest artery
ammonia	Smelly chemical
aromatic hydrocarbon	Smelly Organic
Air pollution	Smog
Gastropod	Snail general
classical learning	socrates teaching
salt	Pepper
hard water	Soft aqua
liquefaction	Soil solidification
prominence	Solar Flare
sunspot	Solar Freckle
sublimation	Solid Gas
phase diagram	Solid Picture
solvent	Solute
solute	Solvent
Extinction	Species death
velocity	Speed
rate constant	Speed Kaylene
rate-determining step	Speed Staircase
rate law	Speed Theory
Arachnid	Spider general
Kelp forest	Spongebob bosk
gametophyte	sporophyte
potato	Spud
Blood	Stab
Stratosphere	Stable atmosphere
Filament	Stamen stem
Anther	Stamen top
amylase	starch enzyme
Echinoderm	Starfish general
metal	Steel
metallurgy	Steel making
Gluon	Sticky particle
digestive system	Stomach general
ulcer	Stomach Sore
Elasticity	Stretchiness
weak base	Strong acid
weak acid	Strong base
weak force	Strong newton
Nitrate	Strong Nitrogen 
Hadron	Large collider
Addition reaction	Subtraction comeback
Addition Polymerization	Subtraction monomer
leaching	sucking blood
Formal Charge	Suit Stampede
Solar Eclipse	Sun covering
Solar eclipse	Sun Covering
Solar System	Sun family
solar wind	Sun Fart
Mangrove	Sundarbans
colloid	Suspension
esophagus	Swallowing pipe
Marsh	Swamp
Decomposition	Synthesis
Domain	Tax 0
Kingdom	Tax 1
Phylum	Tax 2
Class	Tax 3
Order	Tax 4
Family	Tax 5
Genus	Tax 6
Species	Tax 7
Prophase	Telophase
heat capacity	Temperature limit
Thermodynamics	Temperature physics
kelvin	temperature unit
electricity	Tesla
electrochemistry	Tesla Aparicio
electric field	Tesla camp
Electromagnetic radiation	Tesla Faraday
electrical conductivity	Tesla train
Gonad	Testes ovaries
state	Texas
Temperature	Thermometer measures
half life	Three confirmed
triple point	Three decimal
triple bond	Three james
Temporal Lobe	Time brain
Buret	Titration device
Coevolution	Together creationism
Monodentate ligand	Tooth magnesium
surface tension	Top Water
conductor	Train
Cyclotron	Transformers mega
Longitudinal Wave	Transverse tsunami
Detritivore	Trash Eater
Detritus	Trash
Deforestation	Tree cutting
Ozone	Triple oxygen
Fish	Trout general
wave function	Tsunami purpose
Chromosome	Twenty three
Diamagnetism	Two Faraday
double bond	Two james
Biped	Two Legs
secondary structure	Two Protein
Dipole	Two Santa
binary star	Two stellar
disaccharide	Two sugar
Hypotonic	Underfilled
aquifer	Underground Water
Neutrino	Undetectable particle
big bang	Universe Beginning
vestigial organ	Unnecessary body
Degenerate orbitals	Unruly Circles
urethra	Ureter
ureter	Urethra
urea	Urine chemical
core electron	Valence positron
Evaporate	Vaporize
Ocean acidification	Varun science
cambium	Vascular blank
Antidiuretic Hormone	Vasopressin
artery	Vein
conjugate base	Verb acid
conjugate acid	Verb base
conjugation	Verb Changing
serum	Verita
bacteria	Virus
bacteroid	Virus Asteroid
Ocular Nerve	Vision Brain 
Macular Degeneration	Vision loss
larynx	voice box
caldera	Volcanic dome
igneous rock	volcanic stone
scavenger	Vulture general
tectonic plate	Wagner dish
Cellulose	Wall material 
spectator ion	Watching Drake
vapor pressure	water barometer
Aquaculture	Water farming
Distillation	Water purification
Adhesion	Water stickiness
power	Watt Measures
amplitude	Wave height
strong base	Weak Acid
strong acid	Weak Base
strong force	Weak Newton
Nitrite	Weak Nitrogen
erosion	Weathering
mass	weight
mass percent	weight hundred
mass spectrometer	weight light
mass defect	weight loss
mass number	weight numeral
Occipital Lobe	Western brain
hydride	wet hydrogen
axle	Wheel and
trachea	Wind pipe
glass	Window material
Copper	Wire element
Asthenosphere	Wisdom Earth
Aerobic respiration	With oxygen
syngas	Without Fart
Anaerobic respiration	Without oxygen
Decomposer	Worm Fungi
phloem	Xylem
Capillary Action	Xylem moving
String theory	Yarn law
Loess	Yellow soil
Galvanizing	Zinc Coating
blastula	Zygote embryo